l  1
g -1 -1 -1 -1 -1 -1 -1 -1 -1 -1
g -1 -1 -1 -1 -1 -1 -1 -1 -1 -1
g -1 -1 -1 -1 -1 -1 -1 -1 -1 -1
g -1 -1 -1 -1 -1 -1 -1 -1 -1 -1
g -1 -1 -1 -1  0  0  0 -1 -1 -1
g -1  2  0  0  0  0  1  0  3 -1
g -1 -1 -1 -1 -1 -1 -1 -1 -1 -1
g -1 -1 -1 -1 -1 -1 -1 -1 -1 -1
g -1 -1 -1 -1 -1 -1 -1 -1 -1 -1
g -1 -1 -1 -1 -1 -1 -1 -1 -1 -1
p  5  8
w  5  1