l  3
g -1 -1 -1 -1 -1 -1 -1 -1 -1 -1
g -1 -1  0  0  0  3 -1 -1 -1 -1
g -1 -1  0 -1 -1  1 -1 -1 -1 -1
g -1 -1  0 -1  0  1  0 -1 -1 -1
g -1  0  1  1  0  0  1  0  0 -1
g -1  0  0 -1 -1  0 -1  0  0 -1
g -1  0 -1 -1 -1 -1 -1 -1  0 -1
g -1  1 -1 -1 -1 -1 -1 -1  0 -1
g -1  0  0  0  0  0  0  2  0 -1
g -1 -1 -1 -1 -1 -1 -1 -1 -1 -1
p  1  5
w  8  7